XXXXXTXXX
XPX E   X
X X EK  X
X XXXXX X
X       X
XXXXXXXXX