XXXXXTXXX
XPX E   X
X X EK  X
X X     X
X       X
XXXXXXXXX