XXXXXXXXX
X X E   X
X X E   X
X XXXX  X
X       X
XXXXXXXXX