XXXXXXXXX
XPX E   X
X X EK  X
X XXXXXDX
X       T
XXXXXXXXX