XXXXXXXXXX
X  X EEE X
X  X     X
X  XXXX  X
X        X
XXXXXXXXXX