XXXXXXXXX
X X EE  X
X X     X
X XXXX  X
X       X
XXXXXXXXX