XXXXXTXXXXXXXX
XP X  E X  K X
X  D    X    X
X  X EE XXXX X
X  XXXXXXXXX X
X  X   EE  X X
X  X  EE   D X
X  XXXXXXXXX X
X            X
XXXXXXXXXXXXXX