XXXXXXXXXXXTXX
XP X  EEX  K X
X       X EE X
X  XXXXXXXXX X
X  X   EE  X X
X  X   EE  X X
X  X         X
X  XXXXXXXXX X
X            X
XXXXXXXXXXXXXX