XXXXXXXXXXXXXXXXXXXXXXXXTXXX
XP      X  X  E       X    X
X X E E  E X     EK   XXXX X
X XXX XXXXXX         E   X X
X X     E  X XXXXXXXXXXXXX X
X X    E   X             X X
X X XXXXXXXXE   X  E  E  X X
X X    E   XXXXXX XXXXXXXX X
X X   E    X  E   X    E X X
X X               X  E   X X
X X  E     X             X X
XEXXXXXXXXXXXXXXXXXXXXXXXX X
X    EE               EE   X
X                          X
XXXXXXXXXXXXXXXXXXXXXXXXXXXX